{
  "encodedLevel": [
    [
      [   0,    0,    0,    0,    0,    0,    0,    0,    0,    0,    0,    0,    0,    0,    0,    0,    0,    0,    0,    0],
      [   0,    0,  502,    0,    0,    0,    0,    0,    0,    0,    0,    0,    0,    0,    0,    0,    0,    0,    0,    0],
      [   0,    0, 1020,    0,    0,    0,    0,    0,    0,    0,    0,    0,    0,    0,    0,    0,    0,    0,    0,    0],
      [   0,    0,    0,    0, 1020,    0, 1020,    0,    0,    0,    0,    0,    0,    0,    0,    0,    0,    0,    0,    0],
      [   0,    0,    0,    0,    0,    0,    0,    0,    0,    1,    0,    0,    0,    0,    0,    0,    0,    0,    0,    0],
      [   0,    0,    0,    0,    0,    0,    0,    0, 1011, 1012, 1012, 1013,    0,    0,    0,    0,    0,    0,    0,    0],
      [   0,    0,    0,    0,    0,    0,    0,    0, 1010, 1010, 1010, 1010,    0,    0,    0,    0,    0,    0,    0, 1020],
      [   0,    0,    0,    0,    0,    0, 1020,    0, 1010, 1010, 1010, 1010, 1020,    0,    0,    0,    0,    0,    0,    0],
      [   0,    0,    0,    0, 1020,    0,    0,    0, 1010, 1010, 1010, 1010,    0,    0, 1000, 1002,    3,    3, 1000, 1001],
      [1001, 1001, 1002,    0,    0,    0,    0,    0, 1010, 1010, 1010, 1010,    0,    0, 1006, 1007, 1007, 1007, 1007, 1007]
    ],
    [
      [   0,    0,    0,    0,    0,    0,    0,    0,    0,    0,    0,    0,    0,    0,    0,    0,    0,    0,    0,    0],
      [   0,    0,    0,    0,    0,    0,    0,    0,    0,    0,    0,    0,    0,    0,    0,    0,    0,    0,  501,    0],
      [   0,    0,    0,    0,    0,    0,    0,    0,    0,    0,    0,    0,    0,    0,    0,    0,    0, 1000, 1002,    0],
      [   0,    0,    0,    0,    0,    0,    0,    0,    0,    0,    0,    0,    0,    0,    0, 1020,    0, 1003, 1005,    0],
      [   0, 1000, 1001, 1002,    0,    0,    0,    0,    0,    0,    0,    0,    0,    0,    0,    0,    0,    0,    0,    0],
      [   0, 1003, 1004, 1005,    0,    0,    0,    0,    0,    0,    0,    0,    0, 1020,    0,    0,    0,    0,    0,    0],
      [   0,    0,    0,    0,    0, 1020,    0,    0, 1020,    0,    0, 1020,    0,    0,    0,    0,    0,    0,    0,    0],
      [   0,    1,  502,   -1,    0,    0,    0,    0,    0,    0,    0,    0,    0,    0,    0,    0,    0,    0,    0,    0],
      [1001, 1001, 1001, 1001, 1001, 1002,    3,    3,    3,    3,    3, 1000, 1002,    0,    2,    0,  502,    0,   -2,    0],
      [1007, 1007, 1007, 1007, 1007, 1007, 1007, 1007, 1007, 1007, 1007, 1007, 1008,    0, 1000, 1001, 1001, 1001, 1001, 1001]
    ]
  ],
  "bgLayers": [0, 1, 3, 2],
  "soundtrack": "game-soundtrack",
  "time": 600000
}
